19 16 16 16 16 16 16 16 16 16 16 16 16 16 20
15 1 1 1 1 1 1 1 1 1 1 1 1 1 15
18 1 14 16 20 1 14 16 20 1 19 13 1 1 17
1 1 1 1 15 1 1 1 15 1 15 1 1 1 1
20 1 19 16 18 1 19 16 25 1 15 1 14 16 24
15 1 15 1 1 1 15 1 15 1 15 1 1 1 15
15 1 12 1 11 1 12 1 12 1 17 13 1 16 25
15 1 1 1 15 1 1 1 1 1 1 1 1 1 15
15 1 19 24 25 1 14 16 20 1 11 1 11 1 15
15 1 15 15 15 1 1 1 15 1 23 20 15 1 15
18 1 15 15 15 1 19 16 25 1 15 15 15 1 17
1 1 12 12 12 1 15 1 15 1 15 17 25 1 1
20 1 1 1 1 1 12 1 12 1 12 1 12 1 19
15 1 14 13 1 1 1 1 1 1 1 1 1 1 15
17 16 16 16 16 16 16 16 16 16 16 16 16 16 18
