19 16 16 16 16 16 16 16 16 16 16 16 16 16 20
15 1 1 1 1 1 1 1 1 1 1 1 1 1 15
18 1 11 1 11 1 19 16 13 1 11 1 11 1 17
1 1 15 1 15 1 15 1 1 1 15 1 15 1 1
20 1 15 -26 15 1 15 -28 1 1 15 1 17 16 24
15 1 17 16 18 1 17 16 13 1 15 1 1 1 15
15 1 1 1 1 1 1 1 1 1 15 1 11 1 15
15 1 19 16 13 1 19 16 20 1 15 1 12 1 15
15 1 15 1 1 1 15 0 15 1 15 1 1 -29 15
18 1 17 16 20 1 23 16 25 1 15 1 14 16 22
1 1 1 1 15 1 15 0 15 1 15 1 1 1 1
20 1 14 16 18 1 17 16 18 1 15 1 19 16 24
15 1 1 1 1 1 1 1 1 1 12 1 12 1 15
15 1 1 11 1 11 1 1 1 1 1 1 1 1 15
17 16 16 22 16 22 16 16 16 16 16 16 16 16 18
