19 16 16 16 16 16 16 24 16 16 16 16 16 16 20
15 1 1 1 1 1 1 15 1 1 1 1 1 -28 15
15 1 10 1 11 1 14 22 13 1 11 1 10 1 15
15 1 1 1 15 1 1 1 1 1 15 1 1 1 15
18 1 14 16 22 20 1 11 1 19 22 16 13 1 17
1 1 1 1 1 15 1 15 1 15 1 1 1 1 1
20 1 14 20 1 12 1 15 1 12 1 19 13 1 19
15 1 1 15 1 1 1 15 1 1 1 15 1 1 15
23 13 1 12 1 19 16 22 16 20 1 12 1 14 25
18 1 1 1 1 15 1 1 1 15 1 1 1 1 17
1 1 11 1 1 15 1 11 1 15 1 1 11 1 1
20 1 12 1 14 18 1 15 1 17 13 1 12 1 19
15 1 1 1 1 1 1 12 1 1 1 1 1 1 15
17 20 -26 11 1 11 1 1 1 11 1 11 -29 19 18
0 17 16 22 16 22 16 16 16 22 16 22 16 18 0
